3
Box2.sob
Goal.sob
Door.SOB

8 8

0 1 0 0 0 0 1 0
0 1 0 1 1 0 1 0
0 0 0 0 1 0 1 0
1 1 1 0 0 1 1 0
0 0 0 0 1 0 1 1
0 1 1 1 0 0 0 1
3 0 0 1 0 1 0 1
0 1 0 0 0 1 0 0
