2
Box1.sob
Goal.sob

8 8

1 1 0 1 0 1 0 1
1 0 0 0 0 0 1 0
1 0 1 0 1 0 0 0
1 0 0 1 0 0 1 0
0 1 0 0 1 0 0 1
0 0 0 1 0 1 0 1
0 1 0 0 0 0 0 0
1 0 0 1 1 0 1 0