2

Box3.sob
Goal.sob

8 8

1 0 0 0 1 1 0 1
0 1 1 0 0 0 0 1
0 0 0 0 1 1 0 0
1 0 1 0 0 0 2 1
0 1 0 0 1 0 1 0
0 0 0 1 0 0 0 0 
0 0 1 0 0 0 0 1
1 1 1 0 0 1 0 1